Time;Gols;Vitorias;Empates;Derrotas;Pontos;Aproveitamento;Saldo de Gols;Gols Sofridos
Avai;54;7;5;6;26;48.15;3;51
CSA;32;5;4;9;19;35.19;-8;40
Nautico;43;5;5;8;20;37.04;-12;55
Confianca;48;8;3;7;27;50.00;5;43
Sampaio Correa;52;7;5;6;26;48.15;4;48
Oeste;34;5;0;13;15;27.78;-17;51
Botafogo;41;8;7;3;31;57.41;13;28
Guarani;52;7;6;5;27;50.00;9;43
Figueirense;37;8;4;6;28;51.85;-5;42
Cruzeiro;51;8;5;5;29;53.70;8;43
