Time,Gols,Vitorias,Empates,Derrotas,Pontos,Aproveitamento,Saldo de Gols,Gols Sofridos
Avai,54,7,5,6,26,48.1,3,51
CSA,32,5,4,9,19,35.2,-8,40
Nautico,43,5,5,8,20,37.0,-12,55
Confianca,48,8,3,7,27,50.0,5,43
Sampaio Correa,52,7,5,6,26,48.1,4,48
Oeste,34,5,0,13,15,27.8,-17,51
Botafogo,41,8,7,3,31,57.4,13,28
Guarani,52,7,6,5,27,50.0,9,43
Figueirense,37,8,4,6,28,51.9,-5,42
Cruzeiro,51,8,5,5,29,53.7,8,43
